NO ./textures/north.xpm
SO ./textures/south.xpm
WE ./textures/west.xpm
EA ./textures/east.xpm

F 120,0,0
C 193,18,31

         111111111111
       111000000S000111
     11100001111110000111
    110000011    110000011
   110000111      111000011
  11000011          11000011
  1000011            1100001
  100001              100001
  100001              100001
  1000011            1100001
  11000011          11000011
   110000111      111000011
    110000011    110000011
     11100001111110000111
       1100000000000011
        11111111111111
