
NO ./textures/north.xpm
SO ./textures/south.xpm
WE ./textures/west.xpm
EA ./textures/east.xpm
F 11,21,32
C 135,206,235

            1111111111111111111111
        11111000000000000000000001
        10000100000000000000000011
111111111001000100000000000000001
111111111010000001000000000000011
10000000010000011101000000000111
111101111111110111001000000001
111101111111110111010010000001
110000001101010111000100000001
100000000000000011001000000001
100000000000000011010000000001
11000001110101011110000000N001
11110111 1110101 1000000000001
11111111 1111111 1111111111111