

NO ./textures/north.xpm


SO ./textures/south.xpm

WE ./textures/west.xpm

EA ./textures/east.xpm

F 160,82,45


C 135,206,235

   11111111111
   1N000000001
   10000000001
   11111D11111
   10000000001
   10000000001
   11111D11111
   10000000001
   10000000001
   11111111111
